####################
#P.o.......##.......#
#.###.#####.##.#####.#
#...#...#...#....#...#
#.###.#.#########.##.#
#.....#...#G.....#...#
#####.###.#.###.##.###
    #.#...#...#.#...
#####.###.#####.#####
#.........#.........#
#.#######.#.#######.#
#.........#.........#
#####.###.#####.#####
    #.#...#...#.#...
#####.###.#.###.##.###
#.....#...#......#...#
#.###.#.#########.##.#
#...#...#...#....#...#
#.###.#####.##.#####.#
#o..................o#
####################
