#####################
#o...#........#...o.#
N.##.#.######.#.##..M
#...................#
#.##.#####.#####.##.#
#....#.........#....#
####.#.###-###.#.#..#
#..#.#.#--G--#.#.#..#
#.##.#.#G   G#...####
#......#G   G#......#
####.#.#     #.#..####
A....#.#######.#.#..B
####.#.........#.##.#
#....#....P....#....#
#.##.#####.#####.##.#
#..#...........#....#
X.##.###...###.##.#.Y
#o....#.....#...#.#.#
#.###.#.###.#..##.#.#
#.....#.....#..o....#
#####################